1111111111
1E101P1001
1000000001
100000C001
1000000001
1111111111
