11111111111111111
10000000000000001
10000E00000000001
1000C000000P00001
100000000C0000001
11111111111111111
