11111111
100P0001
10C0C0C1
1E000C01
11111111
