11111111111111
10000P00000001
10000E00000001
10000000C00001
10000000000001
11111111111111
