11111111111111
1E101P10000001
10000000000001
10000000C00001
10000000000001
11111111111111
