11111111111111
10000P00000001
10000E00000001
1000C000000001
100000000C0001
11111111111111
