11111111111111
10001P10000001
100000E0000001
10000000C00001
10000000000001
11111111111111
